10 12 0 0 9 11
S...........
.###..##..#.
...#.....#..
.#....##....
..##....##..
...#..#.....
.#..##......
..##..##....
......##..#.
...........G
